FFFFF.2.2.2.FFFFF
FFFFF.......FFFFF
FFFFFFFFFFFFFFFFF
FFFFFFFFFFFFFFFFF
FFFFFFFFFFFFMMMFF
FFFYMMFFFFFFMMMFF
FFFMMMFFFFFFFFFFF
FFFFFFFFFFFFFFFFF
FFFFFFFFMMCFFFFFF
FFFFFFFFMMMFFMMMM
FFYMFFFFFFFFFMMMM
FFMMFFFFFFFFFFFFF
FFMMMMMFFFFFFFFFF
FFFFF.......FFFFF
FFFFF.D.....FFFFF
FFFFF....D..FFFFF
FFFFF.......MMMFF
MMMFF......DYMMFF
MMCFF..D....FFFFF
FFFFF.......FFFFF
FFFFFFFFFMMMFFFFF
FFFFFFFFFFFMFFFMM
FFFFMMMFFFFMMFFMM
FFFFMMMFFFFMMFFFF
FFFFFFFFFFFMYFFFF
MMFFFFFFFFFFFFFFF
MMFFFFFFFFFFFFFFF
FFFFFMMFFFFFMMFFF
FFFFFMMFFFFFMMFFF
FFFFFMCFFFFFFFFFF
FFFFFFFFFFFFFFFFF
FFFFF.......FFFFF
FFFFF.1.1.1.FFFFF