FFFFFFF.2.2.2.FFFFFFF
FFFFFFF.......FFFFFFF
FFFFFFFFFFFFFFFFFFFFF
FFFFFFFFFFFFFFFFFFFFF
FFFFFFFFFFFFFFMMMFFFF
FFFFFYMMFFFFFFMMMFFFF
FFFFFMMMFFFFFFFFFFFFF
FFFFFFFFFFFFFFFFFFFFF
FFFFFFFFFFFFFFFFFFFFF
FFFFFFFFFMMCFFFFFMMMM
FFFFFFFFFMMMFFFFFMMMM
FFFFYMFFFFFFFFFFFFFFF
FFFFMMFFFFFFFFFFFFFFF
FFFFMMF.......FFFFFFF
FFFFFFF.D.....FFFFFFF
FFFFFFF....D..FFFFFFF
FFFFFFF.......MMMFFFF
FFMMMFF......DYMMFFFF
FFMMCFF..D....FFFFFFF
FFFFFFF.......FFFFFFF
FFFFFFFFFFFFFFFFFFFFF
FFFFFFFFFFFFFFFFFMMFF
FFFFFFMMMFFFFMMFFMMFF
FFFFFFMMMFFFFMMFFFFFF
FFFFFFFFFFFFFMYFFFFFF
MMMMFFFFFFFFFFFFFFFFF
MMMMFFFFFFFFFFFFFFFFF
FFFFFFFMMFFFFFMMFFFFF
FFFFFFFMMFFFFFMMFFFFF
FFFFFFFMCFFFFFFFFFFFF
FFFFFFFFFFFFFFFFFFFFF
FFFFFFF.......FFFFFFF
FFFFFFF.1.1.1.FFFFFFF