WWWWWWWWWWWWWWWWWWWWWWWWWWWWWWWWWWWWWWWWWWWWWWWWWWWWWWWWWWWW
WWWWWWWWWWWWWWWWWWWWWWWWWWWWWWWWWWWWWWWWWWWWWWWWWWWWWWWWWWWW
WWWWWWWWWWWWWWWWWWWWWWWWWWWWWWWWWWWWWWWWWWWWWWWWWWWWWWWWWWWW
WWWWWFFFMMWWWWWWWWWWWWWWWWWWWWWWWWWWWWWWWWWWWWWWWWMMFFFWWWWW
WWWWFFF.4MMWWWWWWWWWWWWWWWWFFFFFFWWWWWWWWWWWWWWWWMM4.FFFWWWW
WWWFFF....MMWWWWWWWWWWWFFFFFFFFFFFFFFWWWWWWWWWWWMM....FFFWWW
WWWFF.2.2..MWWWWWWWWMMFFFFFFFFFFFFFFFFMMWWWWWWWWM..2.2.FFWWW
WWWF..1....MMWWWWWMMMMFFFFFFCFFCFFFFFFMMMMWWWWWMM....1..FWWW
WWWM4....D..MWWWMMMMMMFFFFFFN..NFFFFFFMMMMMMWWWM.......4MWWW
WWWMM.......MMMMMFFFMMFFFFFFN44NFFFFFFMMFFFMMMMMD......MMWWW
WWWWMM......FFFFFFFF4MFFFFFFCFFCFFFFFFM4FFFFFFFF......MMWWWW
WWWWWMMM...FFFFFFFFFFMFFFFFFFFFFFFFFFFMFFFFFFFFFF...MMMWWWWW
WWWWWWWMMMFFFFFFFFFFFFFFFFFFFFFFFFFFFFFFFFFFFFFFFFMMMWWWWWWW
WWWWWWWWWMFFFFFFFFFFFFFFF..........FFFFFFFFFFFFFFFMWWWWWWWWW
WWWWWWWWWMFFFFFFFFFFFF................FFFFFFFFFFFFMWWWWWWWWW
WWWWWWWWWMFFFFFFFFFFF.........1........FFFFFFFFFFFMWWWWWWWWW
WWWWWWWWMMFFFFFFFFYY....D...............YYFFFFFFFFMMWWWWWWWW
WWWWWWWWMFFFFFFFFYY......FMM4..4MMF......YYFFFFFFFFMWWWWWWWW
WWWWWWWMMFFFFFFFYYY......FMMMMMMMMF.D....YYYFFFFFFFMMWWWWWWW
WWWWWWWMMFFFFFFFY...4Y...FFFMMMMFFF...Y4...YFFFFFFFMMWWWWWWW
WWWWWWMMMM4FFFFF....4Y................Y4....FFFFF4MMMMWWWWWW
WWWWWWMMMMMMFFF....YYY...D....1.......YYY....FFFMMMMMMWWWWWW
WWWWWWFFFFFFFF.....................D..........FFFFFFFFWWWWWW
WWWWWFFFFFFFFF...............MM4..............FFFFFFFFFWWWWW
WWWWWFFFFFFFFF.D....D.......MMMMMF............FFFFFFFFFWWWWW
WWWWWFFFFFFFF....FFF........BFFFFF......FFF....FFFFFFFFWWWWW
WWWWWFFFFFFFF....MMF....FF..............FMM....FFFFFFFFWWWWW
WWWWFFFFFFFFF....MMF....MF..............FMM.D..FFFFFFFFFWWWW
WWWWFFFCNNCFF....4MM...4MF....D...BM....MM4....FFCNNCFFFWWWW
WWWWFFFF.4FFF.....MM...MMF........FMM...MM.....FFF4.FFFFWWWW
WWWWFFFF.4FFF.....MM.1.MMF..2.2...FMM.1.MM.....FFF4.FFFFWWWW
WWWWFFFCNNCFF..D.4MM....MB........FM4...MM4....FFCNNCFFFWWWW
WWWWFFFFFFFFF....MMF.D............FM....FMM....FFFFFFFFFWWWW
WWWWWFFFFFFFF....MMF..............FF..D.FMM....FFFFFFFFWWWWW
WWWWWFFFFFFFF....FFF......FFFFFB........FFF....FFFFFFFFWWWWW
WWWWWFFFFFFFFF............FMMMMM..............FFFFFFFFFWWWWW
WWWWWFFFFFFFFF..D...........4MM...............FFFFFFFFFWWWWW
WWWWWWFFFFFFFF.............D.......D..........FFFFFFFFWWWWWW
WWWWWWMMMMMMFFF....YYY........1.......YYY....FFFMMMMMMWWWWWW
WWWWWWMMMM4FFFFF....4Y................Y4....FFFFF4MMMMWWWWWW
WWWWWWWMMFFFFFFFY...4Y...FFFMMMMFFF...Y4...YFFFFFFFMMWWWWWWW
WWWWWWWMMFFFFFFFYYY......FMMMMMMMMF......YYYFFFFFFFMMWWWWWWW
WWWWWWWWMFFFFFFFFYY......FMM4..4MMF......YYFFFFFFFFMWWWWWWWW
WWWWWWWWMMFFFFFFFFYY...D............D...YYFFFFFFFFMMWWWWWWWW
WWWWWWWWWMFFFFFFFFFFF.........1........FFFFFFFFFFFMWWWWWWWWW
WWWWWWWWWMFFFFFFFFFFFF................FFFFFFFFFFFFMWWWWWWWWW
WWWWWWWWWMFFFFFFFFFFFFFFF..........FFFFFFFFFFFFFFFMWWWWWWWWW
WWWWWWWMMMFFFFFFFFFFFFFFFFFFFFFFFFFFFFFFFFFFFFFFFFMMMWWWWWWW
WWWWWMMM...FFFFFFFFFFMFFFFFFFFFFFFFFFFMFFFFFFFFFF...MMMWWWWW
WWWWMM......FFFFFFFF4MFFFFFFCFFCFFFFFFM4FFFFFFFF......MMWWWW
WWWMM.......MMMMMFFFMMFFFFFFN44NFFFFFFMMFFFMMMMM.......MMWWW
WWWM4.......MWWWMMMMMMFFFFFFN..NFFFFFFMMMMMMWWWM.......4MWWW
WWWF..1....MMWWWWWMMMMFFFFFFCFFCFFFFFFMMMMWWWWWMM...1...FWWW
WWWFF.2.2..MWWWWWWWWMMFFFFFFFFFFFFFFFFMMWWWWWWWWM..2.2.FFWWW
WWWFFF....MMWWWWWWWWWWWFFFFFFFFFFFFFFWWWWWWWWWWWMM....FFFWWW
WWWWFFF.4MMWWWWWWWWWWWWWWWWFFFFFFWWWWWWWWWWWWWWWWMM4.FFFWWWW
WWWWWFFFMMWWWWWWWWWWWWWWWWWWWWWWWWWWWWWWWWWWWWWWWWMMFFFWWWWW
WWWWWWWWWWWWWWWWWWWWWWWWWWWWWWWWWWWWWWWWWWWWWWWWWWWWWWWWWWWW
WWWWWWWWWWWWWWWWWWWWWWWWWWWWWWWWWWWWWWWWWWWWWWWWWWWWWWWWWWWW
WWWWWWWWWWWWWWWWWWWWWWWWWWWWWWWWWWWWWWWWWWWWWWWWWWWWWWWWWWWW